#######################################################################################
#              #                                  #                                   #
#                                                 #                                   #
#                                                 #                                   #
#              #                                  #                                   #
#              ########                           #                                   #
#              #                                  #                                   #
#              #                      #############                                   #
#              #                                                                      #
#              #                                                                      #
#              #                                  #                                   #
#####  ################################################################################
#                                                                                     #
##########  #########################################################   ###############
#                                 #                                                   #
###############################################################################  ######
#                                                                                     #
#      ################################################################################
#                 #####################################################################
##  ###################################################################################
#                                                                                     #
#                                                                                     #
#                                                                                     #
####################################################################     ##############
#                                                                                     #
############################################## ####################################   #
#                                                  #                                  #
#                                                  #                                  #
#                                                  #                                  #
############################################################  #########################
#                                              #                                      #
#                                              #                                      #
############################  ########## ####################################  ########
#                                  #                                                  #
##############        #######################################      ####################
#                     #                                                               #
#                     #                                                               #
#######################################################################################